1111111111111111111111111111
1ECC1CCCCCCCCCCCCCCCCCCCCCC1
1CCC111C1111111111111CCCC1C1
1CCCCPCCCC11CC1CCCCC1CCC1CC1
1CCCCCC11CCC1CCCCCCC1CC1C1C1
1CCCCCC1111CCCCCCCCC1C1CC0C1
1111111111111111111111111111